15 08 05
     XXXX
 XXXXX..X
 X.....JXXXXXXX
XX.XX.GGX..GGGX
X.J.JJXJ..M...X
X........XXX..X
XXXXXXX..X XXXX
      XXXX