11 07 04
XXXXXXX
X.....XXXXX
X.JJXMXXGGX
X.X.......X
X..J.X.X..X
XXXX.J..GGX
   XXXXXXXX