07 07 02
XXXXXX
X...GX
X.XX.XX
X..JJMX
X.X...X
XG..XXX
XXXXX