11 11 05
 XXXXXX
 X.G..X
XXJGX.X
X..*..X
X.GGXXX
XXJ.X XXXXX
XX.XX X...X
X..XXXX.X.X
X...M.J.J.X
XX..X.....X
 XXXXXXXXXX