10 07 03
XXXXXXXXXX
X........X
X.XXGXXX.X
X.X.JJ.G.X
X.G.MJXX.X
XXXXX....X
    XXXXXX