09 07 02
     XXX
XXXXXXMXX
X....G*.X
X...X...X
XXXXXJX.X
    X...X
    XXXXX