11 11 04
      XXXX
XXXXXXX..X
X.J......XX
X.JXXXXX..X
X..MX..X..X
XX.XXGG...X
X..X.GGXXXX
X.J..XXX
X.JXXX
X..X
XXXX