14 09 03
XXXXXXXXXXXXXX
X......X.....X
X.JMJJ.X.G.GGX
XX.XX.XXX.XX.X
 X.X.......X.X
 X.X...X...X.X
 X.XXXXXXXXX.X
 X...........X
 XXXXXXXXXXXXX