11 09 06
XXXXXX
X....XXX
X..X.J.X
X..J.M.X
XX.XX.XXXXX
X..XGGGGGGX
X.J.J.J.J.X
XX...XXXXXX
 XXXXX