09 08 03
      XXX
XXXXX XGX
X...XXXGX
X...J.XGX
X.J..J..X
XXXXXMX.X
    X...X
    XXXXX