07 08 02
 XXXXXX
XX....X
X..XX.X
X.X.J.X
X..*.GX
XX.XMXX
 X...X
 XXXXX