06 07 02
XXXXX
XG..XX
XMJJ.X
XX...X
 XX..X
  XXGX
   XXX