06 07 03
XXXXX
X.M.X
XGGGX
XJJJXX
X....X
X....X
XXXXXX