09 09 12
 XXXXXXX
XX..G..XX
X.GJJJG.X
X.JG.GJ.X
XGJ.M.JGX
X.JG.GJ.X
X.GJJJG.X
XX..G..XX
 XXXXXXX