11 05 04
XXXXXXXXXXX
X....GXX..X
X.JJMGGJJ.X
X...XXG...X
XXXXXXXXXXX