07 11 04
XXXXX
X...X
X.G.X
XGMGXXX
XXGX..X
X..J..X
X.J...X
XXJJ..X
 X..XXX
 X..X
 XXXX