09 10 04
     XXXX
XXXXXX..X
X.......X
X..GGG.GX
XXJXXXXXX
X.J..X
X...JXXX
XX..J..X
 XX.M..X
  XXXXXX