08 07 04
 XXXXXXX
 X.....X
 X.GJG.X
XX.JMJ.X
X..GJG.X
X......X
XXXXXXXX