07 09 02
XXXXXXX
X.....X
XG.G..X
X.XX.XX
X..J.X
XXXJ.X
  XM.X
  X..X
  XXXX