09 13 05
  XXXXXXX
X X.....X
X X.X.X.X
  X.M.J.X
XXX.XXX.X
X...XXX.X
X.J..XXGX
XX.J..XGX
 XX.J..GX
X XX.JXGX
XX XX.XGX
XXX X...X
XXX XXXXX