10 09 04
 XXXXXX
XX....X
X...J.X
X..JJ.X
XXX.GXXXXX
  XXGX.M.X
   XG..J.X
   XG.XXXX
   XXXX