10 09 04
XXXXXXXXXX
X...XX...X
X.J..JMX.X
XXXX.X.J.X
   XGX..XX
 X XGX.JX
 X XG...X
 X XG...X
   XXXXXX