15 07 04
XXXXXXXXXXX
X..G..X...X
X.XG..M...X
X..XGGX.XXXXXXX
XX..XX.JJ.J.J.X
 XX...........X
  XXXXXXXXXXXXX