07 08 06
XXXXXXX
X.....X
X.GJG.X
X.JGJ.X
X.GJG.X
X.JGJ.X
X..M..X
XXXXXXX