10 09 02
XXXXX
X...XXXX
X.X.X.GX
X....J.XXX
XXX.XJG..X
X...XM...X
X.X.XXXXXX
X...X
XXXXX