09 06 04
  XXXX
XXX..XXXX
X.......X
XMJ***G.X
X.......X
XXXXXXXXX