09 08 03
XXXXXXXXX
X.M.X...X
X.J.J...X
XXJXXX.XX
X..GGG..X
X...X...X
XXXXXX..X
     XXXX