13 06 04
   XXXXXXXXXX
XXXX....XX..X
X..JJJGGGGJMX
X......XXX..X
X...XXXX XXXX
XXXXX