14 10 05
   XXXX
   X..XXXXXXXX
XXXX.J.JGGGGGX
X...J...XXXXXX
XMXXX.XXX
X..J..X
X.J.X.X
XX.X..X
 X....X
 XXXXXX