11 08 04
  XXXXXXXXX
XXX...X...X
X.*.J.G.G.X
X...J.XX.XX
XXXX*X...X
 X..M..XXX
 X...XXX
 XXXXX