06 10 05
 XXXX
XX..X
XG.JX
XGJ.X
XGJ.X
XGJ.X
XG.JXX
X...MX
XX...X
 XXXXX