07 07 03
 XXXX
XX..XXX
X.....X
XG**JMX
X...XXX
XX..X
 XXXX