09 09 04
  XXXX
  X..X
  X..XXXX
XXXJGJ..X
X..GMG..X
X..JGJXXX
XXXX..X
   X..X
   XXXX