07 08 03
   XXXX
   X..X
   XM.X
XXXXJGX
X...JGX
X.X.JGX
X....XX
XXXXXX