12 08 05
    XXXXX
XXXXX...XXXX
X.....X....X
X..XGGGGG..X
XX..XX.X.XXX
 XJJMJJJ.X
 X.....XXX
 XXXXXXX