10 11 03
 XXXXX
XX...X
X....XXXXX
X..XGX...X
XM.XGX.J.X
X..XGX..XX
X....X..X
XX..XXJJX
 XX.....X
  X..XXXX
  XXXX