10 08 02
XXXXXXXX
X.M.X..X
X......X
XXXXXJ.X
    X..XXX
 XX XJ.GGX
 XX X..XXX
    XXXX