08 12 02
  XXXXXX
  X.GGMX
  X.JJ.X
  XX.XXX
   X.X
   X.X
XXXX.X
X....XX
X.X...X
X...X.X
XXX...X
  XXXXX