10 07 05
     XXXXX
   XXX...X
XXXXGGGGGX
X.MJJJJJ.X
X.....X.XX
XXXXX...X
    XXXXX