10 06 03
 XXXXXXXXX
 X....X..X
XX.JXJX..X
X..GJGM..X
X..GX....X
XXXXXXXXXX