09 08 02
  XXXXXX
  X....X
  X.XXMXX
XXX.X.J.X
X.GGX.J.X
X.......X
X..XXXXXX
XXXX