08 10 04
XXXXX
X.M.XXXX
X......X
X.J.JJ.X
XXJXX..X
X...XXXX
X.GG..X
XXGG..X
 XXX..X
   XXXX