07 09 02
XXXXX
X...XXX
XG.G..X
X...X.X
XX.X..X
 XMJJ.X
 X....X
 X..XXX
 XXXX