11 08 05
  XXXXXXXXX
XXX.M.X...X
X.*.J.*GG.X
X...J.X...X
XXXX*X..XXX
 X.....XX
 X...XXX
 XXXXX