07 06 02
XXXXX
X...XXX
X..J..X
XX*.G.X
 X...MX
 XXXXXX