06 08 03
 XXXXX
 X.M.X
 X...X
XXXJ.X
X.GGGX
X.JJ.X
XXX..X
  XXXX