09 09 04
  XXXXXX
  X....X
  X..J.X
 XXXXJ.X
XX.J.J.X
XGGGGX.XX
X.....M.X
XX..X...X
 XXXXXXXX