12 06 03
XXXXXX XXXXX
X....XXX...X
X.JJ.....XMX
X.J.XGGG...X
X...XXXXXXXX
XXXXX