07 09 03
XXXX
XG.XX
XGM.X
XG.JX
XXJ.XXX
 X.J..X
 X....X
 X..XXX
 XXXX