07 06 02
XXXXXXX
X.....X
X.X.X.X
XG.J*MX
X...XXX
XXXXX