07 07 02
XXXXXXX
X..*..X
X.....X
XX.X.XX
 XJMGX
 X...X
 XXXXX