13 09 03
XXXXXXXXXXXX
X..........X
X.XXXXXXX.MXX
X.X.........X
X.X..J...X..X
X.JJ.XXXXX..X
XXX..X X.GGGX
  XXXX X....X
       XXXXXX