07 07 03
  XXXX
 XX..X
XXMJGXX
X.JJ..X
X.G.G.X
XXX...X
  XXXXX