12 11 05
  XXXX
XXX..X
X....XXX
X.X.G.GX
X.M.GGGXXXX
X.X.X.X...XX
X...X.JJ...X
XXXXX..J.J.X
    XXJ.X.XX
     X....X
     XXXXXX