11 08 05
 XXXXXXX
XX.....XX
X..J.J..X
X.J.J.J.X
XX.XXX.XXXX
 XM..GGGGGX
 XX.....XXX
  XXXXXXX