13 12 11
       XXXXX
 XXXXXXX...XX
XX.X.MXX.JJ.X
X....J......X
X..J..XXX...X
XXX.XXXXXJXXX
X.J..XXX.GGX
X.J.J.J.GGGX
X....XXXGGGX
X.JJ.X XGGGX
X..XXX XXXXX
XXXX