14 10 10
XXXXXXXXXXXX
XGG..X.....XXX
XGG..X.J..J..X
XGG..XJXXXX..X
XGG....M.XX..X
XGG..X.X..J.XX
XXXXXX.XXJ.J.X
  X.J..J.J.J.X
  X....X.....X
  XXXXXXXXXXXX