18 13 24
     XXXXXXXX
  XXXX......XXXXXX
  X....XX.J.J...MX
  X.XX.XXJXJ.J.JXX
XXX.GGGGGGX..JJ.XX
X...GGGGGGX..X...X
X.X.GGGGGGXJ..J..X
X.XJGGGGGG.JJX.J.X
X...XXX.XXXJ..J.XX
XXX..J..J..J..J.X
  X..J..J..J..J.X
  XXXXXX...XXXXXX
       XXXXX