19 14 18
       XXXXXXXXXXX
       X...X.....X
XXXXX  X.....J.J.X
X...XXXXX.JXX.X.XX
X.J.XX...X.XX.J..X
X.J..MJJ.X.XXJJJ.X
XX.XXX...X.XX....X
XX.X...XXX.XXXXXJX
XX.X.....J..XGGGGX
X..XXX.XX.J.XGGGGXX
X.J...J.X...XGGJG.X
X..XX.J.X..XXGGGG.X
XXXXX...XXXXXXGGGXX
    XXXXX    XXXXX