20 12 12
XXXXXXXXXXXXXXXXXXXX
X....MXX......X...XX
X....XX....J....J.XX
X..XXXGGGGX.X.X..XXX
X...XGGGGX.X.X.J...X
XXX.XGGGX..X.......X
XX..XXGX.....J...J.X
XX..J.J.XXX..X.X.XXX
XX.J.......X.X.J...X
XXXX.J..JX.X.X.X.J.X
XXXX.........X.X..XX
XXXXXXXXXXXXXXXXXXXX