14 12 14
 XXXXXXXXX
 X.......X
 X.J.JJ.JX
XXX.X..J.X
XGX...JJ.XX
XGXXX...J.X
XGXG.J.XX.XXXX
XGGG..JXX.J..X
XGGGJ...J....X
XGGXXXJXXX.XMX
XGGX X.....XXX
XXXX XXXXXXX