20 12 17
XXXXXXXXXXXXXXXXXXXX
X.X.X.X...XMXX...X.X
X.............J....X
X..XXJX.XXXXX.J.X.XX
XX....XXGGGGGX..X..X
XXJXXJXGGGGGXXXJXJ.X
X...X.XXGGGGGX..X.XX
X..J....XXGGXX..X..X
X.J.X...J...J..JJJ.X
XX.J..JX.X..X..J...X
X...XX...X..X......X
XXXXXXXXXXXXXXXXXXXX