19 16 15
  XXXXXX
  X...MXXXX
XXXXX.J...X
X...XX....XXXX
X.J.X..XX....X
X.J.X..XXXXX.X
XX.J..J....X.X
XX.J.J.XXX.X.X
XX.X..J..X.X.X
XX.X.XJX...X.X
XX.XXX...X.X.XXXXXX
X..J..XXXX.X.XGGGGX
X....J....J...GGXGX
XXXXJ..JX.J...GGGGX
X.......X..XX.GGGGX
XXXXXXXXXXXXXXXXXXX