20 12 15
XXXXXXXXXXXXXXXXXXXX
XXGGG...XX.X....X..X
XGGGG.........J.XX.X
XGGGGX.X.XJXXXJ....X
XGGGX....X.......X.X
XXGX..XJ.X.....JXX.X
X..X..X.J.J.XXX..J.X
X.....J..J.X..X.XX.X
XX.X.XX.XJJX.JX..X.X
X..X...J.J.X......XX
X....X.....X..X...MX
XXXXXXXXXXXXXXXXXXXX