20 12 15
XXXXXXXXXXXXXXXXXXXX
X................XXX
X.JX...J.XX..J....XX
X....JXXX....X.JJ.XX
XGXXX.....J.J.XX..XX
XGGGX..X..X....XJ..X
XGGXXJJXXXX.J..X...X
XGGGX......J.XX..XXX
XGGGJ..XXX..X....X.X
XXGG..JX..XX...XXM.X
XXXGX..............X
XXXXXXXXXXXXXXXXXXXX