20 12 16
XXXXXXXXXXXXXXXXXXXX
XM.....XXX...X..X..X
X.X.X..X..J..J.....X
XXXXX.....X.J.JXJX.X
XGXGGX....XXJ.J....X
XGGGGG....J...X...XX
XGGGGG....XXXJXXJXXX
XGXGGX....J....X...X
XXXXX.....X..XJ..J.X
XXXXX..X..J....J.J.X
XXXXX..X..X..X..X..X
XXXXXXXXXXXXXXXXXXXX