20 12 16
XXXXXXXXXXXXXXXXXXXX
X......GGGGX....XXXX
X......GGGG........X
X.X.XXXXXXXXXX.....X
X.XJ...X......XXXGGX
X..J...XJJXXX...XGGX
X.J.XXX.J...J...XGGX
X.J.X...J.J.X..XXGGX
X..X..JJ.X.J.XX...XX
XMXX.JX..J..J.....XX
XX.......XX...X..XXX
XXXXXXXXXXXXXXXXXXXX