20 12 16
XXXXXXXXXXXXXXXXXXXX
X...X....X...X...XMX
X.J......J...J...X.X
XX.XXXGGXX.XXX.....X
X...XGGGGXJX..JXXX.X
X.J.XGGGGX..J..J.J.X
X...XGGGGX.X.X.J.J.X
X...XXGGXX...XJX...X
XXJXX....XX..X..XJXX
X...J..J.....X..X..X
X...X....X...X.....X
XXXXXXXXXXXXXXXXXXXX