20 12 17
XXXXXXXXXXXXXXXXXXXX
X...X...X....X...XMX
X...J..J.....X.J.X.X
XXJX.JXXX.X....JJX.X
X..X..XGXXX..XJ.J..X
X..XJXGGGGX..X.XXX.X
X.J..XGGGGGXX....X.X
XXJ..XGXGGGGXJJ.J..X
X..XXXXXXGGXX.X..X.X
X..J.........J.XXX.X
X...X...X........X.X
XXXXXXXXXXXXXXXXXXXX