20 12 16
XXXXXXXXXXXXXXXXXXXX
X.....X...XXXXX....X
XX.J..X...XXXX..J..X
XXXX.JJ...XGGX..X..X
X..J..J..XXGGXXXX.XX
X.J...XXXGGGG...JJ.X
X..XJX...GGGGX.X.J.X
X.X..X.J.GGXXXJX...X
X.X...J.XGGX...XX..X
X...JX..XXXX...X.JXX
X.X..X....MX......XX
XXXXXXXXXXXXXXXXXXXX