20 12 16
XXXXXXXXXXXXXXXXXXXX
XGGGGXXX...........X
XGGGGXXXXX.X..XJX.XX
XGGGGXXX...XJ..J...X
XGGGGXXX....J..XJJXX
XX..XXXX.JX..XJ.J..X
XX..XXXX..J..J..X..X
XM..XXXXJXXXJXX.J..X
XX........X..X..J..X
XX...XXX..X..J..XXXX
XXXXXXXX..X..X.....X
XXXXXXXXXXXXXXXXXXXX