20 16 15
XXXXXXXXXXXX
X......X...XX
X.J..J...X..XXXXXX
XXXX..XXXXX......X
 XGG..X.....XXXX.X
 XGXXXX..XXXX....X
 XGGGG....X..J.XXXX
 X.GGGX...X.JJJX..XX
XXXGXXXX.XX..JMJ...X
X.....XXXXX.J.X....X
X.XGX.J......JXXXJ.X
X.XGXXXXXXXX..X..J.X
X.XGG........XX..J.X
X.X.XXXXXXX.J.X.X..X
X...X     X.......XX
XXXXX     XXXXXXXXXX