15 12 13
 XXXXXXX
 X..X..XXXXX
XX..X..XGGGXXX
X..JX..XGGG..X
X.J.XJJ.GGG..X
X..JX..XGGG.GX
X...X.JXXXXXXXX
XXJ.......J.J.X
XX..X..JJ.X...X
 XXXXXX..XXJJMX
      X......XX
      XXXXXXXX