11 11 08
      XXXX
XXXXXXX.MX
X.....J..X
X...JXX.JX
XXJXGGGX.X
 X.JGGG..X
 X.XG.GX.XX
 X...X.XJ.X
 XJ..J....X
 X..XXXXXXX
 XXXX