20 12 18
XXXXXXXXXXXXXXXXXXXX
X..X......X...X...XX
X.JX.J.J.XXGGGJ..J.X
X..J..X.XXGGGGX.J..X
X.XX.J.XXGGGGX...J.X
X.J....XGGGGXX.J...X
X.JXX..XGGGX.......X
X...JJJXXJXX..XXX.XX
X.X.X..X...X..X....X
X.J.X..J..XX.......X
X....X....XM.......X
XXXXXXXXXXXXXXXXXXXX