20 12 18
XXXXXXXXXXXXXXXXXXXX
X..X.....X..XX....XX
X.JX...J.X.....XX..X
X.J..J..XGGX.....J.X
X.J.J..XGGGGX...X.XX
X.JX..XGGGGGGXXX.J.X
X...X..XGGGGX..XJ..X
X.J..XXXXGGX...X...X
XX.J...XX.X.X.J..JXX
XXX.J....JXMJ.JX...X
XXXX...X.......X...X
XXXXXXXXXXXXXXXXXXXX