19 16 21
            XXXXX
XXXXX  XXXXXX...X
X...XXXX..J.J.J.X
X.J...XX.XX.XX..XX
X...J.J.....J..J.X
XXX.J..XX.XX.....XX
  X.XXXXX.XXXXXJJ.X
 XXJXXXXX.MXX.....X
 X.J..XXXJXXX.J..XX
 X.J..X...XXX..XXX
 X.JJ.J.X...JJ.X
 X.....X...XX..X
 XXXXXXXGG.GXXX
    XGGGGGGGGGX
    XGGGGGGGGGX
    XXXXXXXXXXX