20 12 13
XXXXXXXXXXXXXXXXXXXX
X.X.....X..........X
X.......J..XX.XXX.XX
XXXXX..XX...J..J...X
XXGGXX..X.X.J.X.X..X
XGGGG..J.....XXJX.XX
XGGGG..JXXXXX...XJXX
XXGGX.X..X...X..J..X
XXXGX.X..J...J..X.MX
XX..J..J.X...X..XXXX
XX.......XXXXXXXXXXX
XXXXXXXXXXXXXXXXXXXX