17 10 10
XXXXXXXXXXXXXXXX
X.......XM.X...X
X.X.X.X.X.J..JJX
X.XGGGX.XJJJ...X
X..GGGX.X.J..JJXX
X.XXGXX.X.XX....X
X.XGGG.....J....X
X.XX.XXX..XXXXXXX
X....X XXXX
XXXXXX