20 12 20
XXXXXXXXXXXXXXXXXXXX
X.....XXXGGXXX.....X
X.JJ..XXXGGXXX..JM.X
X..X.XXGGGGGGX..J..X
X.....XGGGGGGX..J..X
XXXX..XXXGGXXXXXXJ.X
X...JJJ.XGGX....X..X
X.JX...J..J..JJ.XJ.X
X..X..XX.J..XX..X..X
X.J....J.XX.J....J.X
X..X..XX....XX..X..X
XXXXXXXXXXXXXXXXXXXX