16 14 17
XXXXX XXXX
XGGGX X..XXXX
XGGGXXX..J..X
XGGGGXX.J..JXXX
XXGGGGXX...J..X
XXXGGG.XX.J.J.X
X.XX....X..J..X
X..XX.X.XXX.XXXX
X.J.X.XJ..J....X
X..J.M.J....J..X
X...X.J.JJ.J.XXX
X..XXXXXX..XXX
X.XX    XXXX
XXX