19 16 19
XXXX
X..XXXXXXXXXXXXXX
X..X...GGXGGGGGGX
X..X.X.XXXXX.GGGX
XXJX....GGGGGGGGX
X...XXJXXXXXX..XXXX
X.J.X.....XXXXXXM.X
XXJ.X.J...XXXXXX..X
X..J.XJJJXX.......X
X......X....XJXJXXX
X.XXXX.XJJJJJ....X
X.X....J.....X...X
X.X...XX........XXX
X.XXXXXXJXXXXXX.J.X
X........X    X...X
XXXXXXXXXX    XXXXX