20 12 20
XXXXXXXXXXXXXXXXXXXX
XXXXXMXXXGXXGGGXX..X
XXXXXJ..GGXGGGX....X
XXXX....GGGGGGX..J.X
XXX..J.XGGGGGXX.X.XX
XX..JJX.XXXXX..J.J.X
XX.JX.J....XX..JJ..X
XX..X..X....X.J..J.X
XX...JJ.XXX.XJXX...X
XX.JX......J.J..J.XX
XXX....X....X....XXX
XXXXXXXXXXXXXXXXXXXX