19 16 22
XXXXXXXXXXXXXXX
XGGGGGGGGGG..GXXXX
XGGGGGGGGGGJJGX..X
XXXXXXXXXXXJ.X...XX
X......J..J.....J.X
XX.XXXX...X..J.X..X
X......X...XX..X.XX
X..JX..X.XX..XXX.XX
X.J.XJXXX....XXX.XX
XXX..J.X..X..XXX.XX
XXX....J.XX.X..X.XX
 X.J..X..J..J.J...X
 X..J..JXJJJ..X...X
 X..X..J......XXXXX
 X.MXX..X..X..X
 XXXXXXXXXXXXXX