18 16 20
  XXXX
  X..XXXXXXXXX
 XX..XX..X...X
 X..JX.JMJ...XXXX
 XJ..J..X.J.JX..XX
XX..JXX.XJ.J.....X
X..X..X.X...JJJ..X
X.J....J..JXX.XXXX
X.J.J.XJX..X..X
XX..XXX..XXXJ.X
 X..XGGGG.....X
 XXXXGGGGGGXXXX
   XGGGGXXXX
   XGGGXX
   XGGGX
   XXXXX