19 13 20
 XXXXXXXXXXXXXXXXX
 XGGG...X....X...XX
XXGGGGG..JXX.X.XJ.X
XGGGGGGX..J..X....X
XGGGGGGX..X..X.X..X
XXXXXXXXX.J..J.J..X
  X.....XJXXJ.XXJXX
 XX...J....X.J....X
 X..XX.XXX.X..XXJ.X
 X.J.JJ.....J..J..X
 X.J....JXXJ.XXXXXX
 XXXXXXX..M.XX
       XXXXXX