17 16 23
XXXXXXXXXXXXX
XGGGGGGGGXXXX
XGGGXXXX.X..XXXXX
XGGGX..XXX....J.X
XGGGJJ.....J.J..X
X..GX..J.JX.J..XX
XGGGX.XJX...J..X
XGX.X.J...J....X
XG..XJXXXJXXXXJX
XX..X...J.J....X
 X..X..JMJ..X..X
 X..X.XXXX.J..JX
 X..X....XXX...X
 X..X.JJ.X XXXXX
 X..X....X
 XXXXXXXXX