20 12 15
XXXXXXXXXXXXXXXXXXXX
X.....X.....MXGGGXXX
X.....X......XXGGGXX
X.X.X.XXJXX.XX.GGGGX
X...J.X...JJJ..GGGGX
XXXJXXX.JJ..XXX.XXGX
X.....J..X....X.XXXX
X..J..X..XXX..X.X..X
XX.XJXX....J..JJ...X
X...J.XX...X..X.X..X
X.....X....X..X....X
XXXXXXXXXXXXXXXXXXXX