12 15 15
XXXXXXXXXXXX
XX.....XX..X
XX...J...J.X
XXXX.XX.JJ.X
X...J.X....X
X.JJJ.X.XXXX
X...X.X.J.XX
X..X..X..J.X
X.JX.JX....X
X...GGX.XXXX
XXXXGG.J.XMX
XGGGGGX.JX.X
XXGGGGX..J.X
XXXGGXX....X
XXXXXXXXXXXX