20 12 17
XXXXXXXXXXXXXXXXXXXX
XGGGGX.......X..X..X
XGGGGX.X.J..J......X
XGGGG.XX..JX.X.JXJ.X
XGGGX...J...JX..J..X
XGGXXXX..X.J...JJ..X
X......XXXX.XXXX.XXX
X........X...X.....X
X.XX...X...J.X.J.J.X
X.XX....J.XX.J..J..X
X.....MX.....X...X.X
XXXXXXXXXXXXXXXXXXXX