19 16 17
XXXXXXXXXXXX XXXXXX
X...X....X.XXXGGGGX
X...JJX...M..GGGGGX
X...X.XXX...X.GGGGX
XX.XX.XXX..X..GGGGX
 X.J.J.....X.X.XXXX
 X..J.JXX..X......X
XXXX.X..XXXX.X.XX.X
X..X.XJ...XX.X....X
X.J..J..X.XX.X...XX
X.X.J.J....X.X...X
X..J.XX.XX.X.XXXXX
X.JJ.....JJ..X
XX.XX.XXX.J..X
 X....X X....X
 XXXXXX XXXXXX