18 11 16
         XXXX
 XXXXXXXXX..XX
XX..J......J.XXXXX
X...XX.XX...XXGGGX
X.XJJ.J.JJXJXXGGGX
X.X...M...X...GGGX
X..JX.XXXJJ...GGGX
X.J..JJ..J.XXGGGGX
XXXJ.......XXXXXXX
  X..XXXXXXX
  XXXX