19 16 25
             XXXXXX
 XXXXXXXXXXXXXGGGGX
XX...XX.....XXGGGGX
X..JJXX..J.MXXGGGGX
X......JJ.JX..GGGGX
X..J.XX.JJ.X.X.GGGX
X..J.XX.J..X..GGGGX
XX.XXXXX.XXX.XXGXXX
XX...J..J.XX...G..X
X.JXXX..X.XXXXX.XXX
X...J...X.......X
X..J.XJ.J.JXXX..X
X.JJJX.J...X XXXX
X....X..JJ.X
XXXXXX...XXX
     XXXXX