19 13 16
XXXXX
X...XX
X.J..XXXXXXXXX
XX.X.X.......XXXXXX
XX.X...JXJXM..X...X
X..X......J.X...J.X
X..XXX.XXXXXXXXX.XX
X..XX.GG*GGGGG.X.XX
XX.XX.*G*GG*G*.X.XX
X.JXXXXXXXXXX.XXJ.X
X..J...J..J....J..X
X..X...X...X...X..X
XXXXXXXXXXXXXXXXXXX