20 16 25
XXXXXXXXXXXXXXXXXXXX
XGGX....X..........X
XGJ..J..XJJ..JXX.JXX
XGJX..XXX..XX.XX...X
X..X.J.X..JJ...J...X
X.XXX..X.X..XJ..XXXX
X..XX.X.J...XM.X...X
X.J....J..XXGXX..J.X
X..X.JX.JX.J.....XXX
X..X..X..X...XXX...X
X..XXXXXXXX.X......X
X...........X..XGXGX
XXJXXXXXXXXJX...GGGX
X....G*..X....XXGXGX
X.G*GGG*...J..GGGGGX
XXXXXXXXXXXXXXXXXXXX