20 12 15
XXXXXXXXXXXXXXXXXXXX
XM.....X...X.......X
XX.XXX.XX..XXXX.X.XX
X....X.X..JJ.......X
X..X.X.X.J.X.J.XX.XX
X.....J.X..XJJ.X...X
X..XXX..X......XX.XX
XGGXGX.J.X..J.X....X
XGGXGX..J.X.XX.JJ..X
XGGGGXX...JJ..J..X.X
XGGGGGXX........X..X
XXXXXXXXXXXXXXXXXXXX