20 12 16
XXXXXXXXXXXXXXXXXXXX
X...X..XMX.XX..XXXXX
X.X.X..J....J..XXXXX
X.X....XXXXXX.J..XXX
X...X..XGGGGX..JJ..X
XXJXXJXXGGGGX......X
X......XGGGGXXJXXJXX
X..JJ..XGGGGX......X
X.J..J..X..X..XXX..X
XXXXX..J...J....J..X
XXXXX.X....X..X...XX
XXXXXXXXXXXXXXXXXXXX