20 12 16
XXXXXXXXXXXXXXXXXXXX
X..X..XX....X...MXXX
XX....J....X.JXXX..X
XXJX.J.XXJX.J.J....X
X...JX....J......XXX
X.XX...J.XXX..XGGGGX
X.X.JX.X.X.X.XGGGGXX
X....J.J.X..XGGGGXXX
XXJ.XXX..J.XGGGGXXXX
X..X.J........XXXXXX
X......X.X....XXXXXX
XXXXXXXXXXXXXXXXXXXX