19 16 32
 XXX  XXXXXXXXXXXXX
XXMXXXX.......X...X
X.JJ...JJ..J.J.GGGX
X..JJJX....J..XGGGX
X.J...X.JJ.JJ.XGGGX
XXX...X..J....XGGGX
X.....X.J.J.J.XGGGX
X....XXXXXX.XXXGGGX
XX.X..X..J.J..XGGGX
X..XX.X.JJ.J.JXXGGX
X.GGX.X..J......XGX
X.GGX.X.JJJ.JJJ.XGX
XXXXX.X.......X.XGX
    X.XXXXXXXXX.XGX
    X...........XGX
    XXXXXXXXXXXXXXX