20 12 16
XXXXXXXXXXXXXXXXXXXX
X....X..X.X..X..X..X
X.MX.X.XX.J...J...XX
XXXX.X....X..X.J...X
X....X.XX.XJ.XX.XX.X
X......J...J...J...X
XGGXXXJJXX.JXXJ.XX.X
XGGXGX..X.J...J.X..X
XGGGGX.JJ...XXJ.XXXX
XGGGGX..XXXXX......X
XGGGXXX........XX..X
XXXXXXXXXXXXXXXXXXXX