19 16 27
XXXXXX     XXXX
X....XXXXXXX..XXXXX
X...JX..X..J..X...X
X..J..J..J.X.J.J..X
XXJ.J...X.MX.J....X
X..J.XXXXXXXXXXX.XX
X.X...XGGGGGGGX.JX
X.XX..X.GGGGGGX..X
X.X...JGGGGGGGGJ.X
X.X.J.XGGGG.GGX..X
X..J.JXXXXJXXXX.JX
X.J...XXX.J...J..XX
X.J.....J.J..J....X
XX.XXXXXX.J.XXXXX.X
X.........X.......X
XXXXXXXXXXXXXXXXXXX