20 12 18
XXXXXXXXXXXXXXXXXXXX
X..X..X.X....X..X..X
X...J......J.J.....X
XX.X..XJXXXJXX..XX.X
X...J.....J..X..J..X
X.XXXJXXJX...X.J...X
X.X...J.J..XXXXXX.JX
X.J..JJ.J..XMXGXGGGX
X.X.....X..X.XGXGGGX
X.XXXXXXXXXX.XGGGGGX
X............XGGGGGX
XXXXXXXXXXXXXXXXXXXX