05 05 01
XXXXX
X..MX
X.J.X
X.G.X
XXXXX
