17 06 04
XXXXXXXX XXXXXXXX
XGJ....X X......X
X..J...XXXX..J..X
X......MGG.....XX
X.....XXXXX...JGX
XXXXXXXXXXXXXXXXX