07 10 10
XXXXXXX
XXXGXXX
X.G.XXX
XGJ*JGX
XGG..GX
X*XJJJX
X..MJGX
XXJJ..X
X.....X
XXXXXXX