35 06 04
XXXXXXXXXXXXXXXXXXXXXXXXXXXXXXXXXXX
XGG.............................GGX
X.XXXXXXXXXXXXXXXXXXXXXXXXXXXXXX..X
XJJ.............................JJX
X................................MX
XXXXXXXXXXXXXXXXXXXXXXXXXXXXXXXXXXX